8/64/
0000000000000000000000000000000000000000000000000000000000000000
2000000000000000000000000000000000010000000000000000000000000001
0000000000000000000000000000000000010000000000000000000000000001
0000000000000000000000000000000000010000000000000000000000000011
0000000000000000000000011100000000010000111111111100000000000001
0000000000011100111111100000000000000000000000000000000000000011
0000001110000000000000000000000000000000111100000000000000000001
1111111111111111111111111111111111111111111111111111111111111111